00000000
00000000
00001000
00000000
00000100
00000000
00110000
00000000