111001
111111
111111
111111
111111
121111